# Map file for tile-based game
# (Lines that start with '#' are comments)
# The tiles are:
#   (Space) Empty tile
#   A..Z    Tiles A through Z
#   o       Star
#   !       Music Note
#   *       Goal
#   1       Person 1 
#   2       Person 2
#   3       Person 3
#   4       Person 4
#   5       Person 5
#   6       Person 6 
#   7       Virus

AAAAAAAAAAAAAAAAAAAAAAAAAAAAAAAAAAAAAAAAAAAAAAAAAAAAAAAAAAAAAAAAAAAAAAAAAAAAAAAAAAAAAAAAAAAAAAAAAAAAAAAAAAAAAAAAAAAAAAAAAAAAAAAAAAAAAAAAAAAAA
A                         1   F      F                                                   F                                                  A
A                             F      F      FFFFFFFFFFFFFFFFFFFFFFFFF     2         1    F                    7       FFFFFFFF              A
A                             F      F      F                        F          F        F     FFFFFFFFF        F     FFFFFFFF7             A
A        F                   F       F      F   7         FFFFFF      F         F        F                      F     FFFFFFFF              A
A        F                  F        F      F                  F      F         F        F    3                 F     FFFFFFFF              A
A        F                 F     3   F      F                  F     F          F        F     FFFFFFFFF        F     FFFFFFFF              A
A         F        7      F           F     F             2   F     F           F        F             F        F     FFFFFFFF         1    A
A          F             F             F  7  F               F     F            F        F             F        F     FFFFFFFF              A
A           FFFFFFFFFFFFF               F     F             F     F             F        F    7        F        F     FFFFFFFF              A
A  7                                     F     FFFFFFFFFFFFF     F        6     F     7  F             F        F     FFFFFFFF              A
A                             5           F           3         F               F        F       FFFFFFF        F     FFFFFFFF              A
A                                          FFFFFFFFFFFFFFFFFFFFF                F        F       F        6     F     FFFFFFFF              A
A          FFFFFFFFFFFFFF                                                       F        F       F              F     FFFFFFFF              A         
A         F       2      F                                                      F        F       F              F     FFFFFFFF    7         A
A        F                F                 F                     F             F        F       FFFFFFFFFFFFFFFF     FFFFFFFF              A
A       F                  F                 F                   F              F        FFF  FFFF                    FFFFFFFF              A
A      F                    F        4        F            7    F               F    4                    FFFFFFF     FFFFFFFF              A
A     F        7             F                 F               F                F        FFFFFFFFFFFFF    F           FFFFFFFF              A
A      F                F                                                       F        F           F    F           FFFFFFFF              A
A       F              F                         F           F                  F        F                F           FFFFFFFF     5        A
A        F            F                           F  6      F                7  F        F     4     F    F           FFFFFFFF              A
A         FFFFFFFFFFFF                             F       F                    F        F           F    F           FFFFFFFF              A  
A                                        7          F     F                     F       FFFFFFFFFFFFF    FFFFFFFFFFFFFFFFFFFFFFFFFFFFFFFFFFA                       
A                                                                               F                     7                                 5  A
AAAAAAAAAAAAAAAAAAAAAAAAAAAAAAAAAAAAAAAAAAAAAAAAAAAAAAAAAAAAAAAAAAAAAAAAAAAAAAAAAAAAAAAAAAAAAAAAAAAAAAAAAAAAAAAAAAAAAAAAAAAAAAAAAAAAAAAAAAAAA       
