# Map file for tile-based game
# (Lines that start with '#' are comments)
# The tiles are:
#   (Space) Empty tile
#   A..Z    Tiles A through Z
#   o       Star
#   !       Music Note
#   *       Goal
#   1       Person 1 
#   2       Person 2
#   3       Person 3
#   4       Person 4
#   5       Person 5
#   6       Person 6 
AAAAAAAAAAAAAAAAAAAAAAAAAAAAAAAAAAAAAAAAAAAAAAAAAAAAAAAAAAAAA
A                                                           A
A        1            6             4          2            A
A                                                           A
A                                                    6      A
A         AAAAAA           4        AAAAAA                  A
A         A                              A                  A
A         A        2                     A             1    A
A      4  A                      3       A   5              A
A         A                              A                  A
A                                                      5    A
A                                                           A
A                                                           A
A       6          5         1             2        3       A
A                                                           A
A                                                           A
A          A                             A                  A
A          A                          4  A                  A
A       3  A       2                     A       4          A
A          A                             A                  A
A          AAAAAA          3        AAAAAA            5     A
A                                                           A
A    1                        6                             A
A                  2                                        A
A                                        3                  A
A      5                      6                      1      A
AAAAAAAAAAAAAAAAAAAAAAAAAAAAAAAAAAAAAAAAAAAAAAAAAAAAAAAAAAAAA