# Map file for tile-based game
# (Lines that start with '#' are comments)
# The tiles are:
#   (Space) Empty tile
#   A..Z    Tiles A through Z
#   o       Star
#   !       Music Note
#   *       Goal
#   1       Person 1 
#   2       Person 2
#   3       Person 3
#   4       Person 4
#   5       Person 5
#   6       Person 6 
#   7       Virus
CCCCCCCCCCCCCCCCCCCCCCCCCCCCCCCCCCCCCCCCCCCCCCCCCCCCCCCCCCCCCCCCCCCCC
E                                                                   D
E                        B                B        3                D
E      7         1       B                B                  7      D
E                        B       2        B                         D
E                        B                B                         D
E      2                 B                B           1             D
E                   6                                               D
E   BBBBBBBBBB          BBBBBBBBBBBBBBBBBBBB      BBBBBBBBBB        D
E                      B                    B          6            D
E        1            B                      B                      D
E   BBBBBBBBBB       B                        B   BBBBBBBBBB        D
E                    B                        B       1             D
E      6             B                      7 B                     D
E   BBBBBBBBBB       B                        B   BBBBBBBBBB        D
E                     B                      B                      D
E                      B                    B                       D
E                       BBBBBBBBB   BBBBBBBB                        D
E     1                                                 2           D
E                        B                B                         D
E             3          B                B                         D
E                        B                B                         D
E       7                B       1        B                 7       D
E                                                                   D
CCCCCCCCCCCCCCCCCCCCCCCCCCCCCCCCCCCCCCCCCCCCCCCCCCCCCCCCCCCCCCCCCCCCC